48
26
WWWWWWWWWWWWWWWWWWWWWWWWWWWWWWWWWWWWWWWWWWWWWWWW
WWWWWWWWWFFFFFWWWWWWWWWWWWWWWFFFWWWFFFFFFFFFFFFW
WWWWWWWWWFFFFFWWWWWWWWWWWWWWWFFFWWWFFFFFFFFFFFFW
WWWWWWWWWFFFFFWWWWWWWWWWWWWWWFFFWWWFFFFFFFFFFFFW
WWWWWWWWWFFFFFWWWWWWWWWWWWWWWWFWWWWFFFFFFFFFFFFW
WWWWWWWWWFFFFFWWWWWWWWWWWWWWWWFWWWWFFFFFFFFFFFFW
WWWWWFFFFFFFFFFFFFWWWWWWWWWWWWFWWWWWWWWWWFWWWWWW
WWWWWFFFFFFFFFFFFFWWWWWWWWWWWWFWWWWWWWWWWFWWWWWW
WFFFFFFFFFFFFFFFFFFFFFWWWWWWWWFWWWWWWWWWWFWWWWWW
WFFFFFFFFFFFFFFFFFFFFFFFFFFFFFFFFFFFFFFFFFFFFFFW
WFFFFFFFFFFFFFFFFFFFFFWWWWWWWWFWWWWWWWWWWWWWWWWW
WFWWWFFFFFFFFFFFFFWWWWWWWWWWWWFWWWWWWWWWWWWWWWWW
WFWWWFFFFFFFFFFFFFWWWWWWFWWWWWFWWWWWWWWWWWWWWWWW
WFWWWWWWWFFFFFWWWWWWWWWWFWWWWWFWWWWWWWWWWWWWWWWW
WFWWWWWWWFFFFFWWWWWWWWWWFWWWWWFWWWWWWWWWWWWWWWWW
WFWWWWWWWFFFFFWWWWWWWWWWFWWWWWFWWWWWWWWWWWWWWWWW
WFWWWWWWWWWFWWWWWWWWWWWWFWWWWWFWWWWWWWWWFFFWWWWW
WFFFFFFFFFFFWWWWWFFFFFFFFFFFFFFFFFFFFFFFFFFWWWWW
WFWWWWWWWWWFWWWWWWWWWWWWFWWWWWWWWWFFFWWWWWWWWWWW
WFWWWWWWWWWFWWWWWWWWWWWWFWWWFWWWWWWWWWWWWWWWWWWW
WFWFFFFFFFWFWWWWWWWWWWWWFWWWFWWWWWWWWWWWWWWWWWWW
WFFFFFFFFFFFWWWWWWWWFFFFFFFFFWWWWWWWWWWWWWWWWWWW
WFWFFFFFFFWFWWWWWWWWFWWWFWWWWWWWWWWWWWWWWWWWWWWW
WFWWWWWWWWWFWWWWWWWWFWWWFWWWWWWWWWWWWWWWWWWWWWWW
WFWWWWWWWWWFWWWWWWWWWWWWFWWWWWWWWWWWWWWWWWWWWWWW
WFWWWWWWWWWFFFFFFFFFFFFFFFFFFFFWWWWWWWWWWWWWWWWW
WWWWWWWWWWWWWWWWWWWWWWWWWWWWWWWWWWWWWWWWWWWWWWWW
